NO ./assets/textures/coord/north.xpm
EA ./assets/textures/coord/east.xpm
WE ./assets/textures/coord/west.xpm
SO ./assets/textures/coord/south.xpm

C 255,000,000 
F 000,255,000

    1111111111111111
11111010011000101001
10101111011010111101
10000000000000000001
 1111111011111111111
    111000000011    
1111000111110011
10000000010000101111
10101111011010111101
10000W00000000000001
11111111011111111101
11111111111111111111
