NO ./assets/textures/intra/sand_wall2.xpm
SO ./assets/textures/intra/sand_wall3.xpm
WE ./assets/textures/intra/sand_wall.xpm
EA ./assets/textures/univers3/east.xpm


F 194,169,120
C 216,232,250

1111                                        1111111
1001                                        1000001
1001111111111                     11111111111000001
1000100011111111    111111        11000000000010001
1000100001111111   1110011111     11000000001010001
100010101101111111111000001111    110011111100100011
1101100001000001110000000011111111110011000111100001
1000000000000000000000000000000000000010000000000101
1000000001001100000000000000000000000000000000000101
1000000101111111111111111110011111100111111111100001
1110110011                100111111001        100111
  101 1111                101111111001        1001
  101111    11111111111111100100000001        1001
  100001111110000000000000001100000001        1001
11100001111111001111111111100101111111  111111100111
10000000000000001         100101        100100000001
10000000000000111         100101        100000000101
111111101111111           100101        110110010101
      101                1100001        100110010101
      101                110001011111111100110010101
    1110111              110000000000001100010010101
111110000011111          110000000000001100011011111
100000000000001         110000000000000110001111
100000000000001         100000111000000111011
100000000000001         100001111100000000001
100000000001011         111011111110000000001
100000000001011           1011111110000000001
10001111111111    1111    1011111110000010001
100011000000011  11001    1011111110000011111
1000100000000011110001    101111110000001
1000100000000000000011    100000000000001
10001000000000000000111111111111000000001
10000000000000000000000000000000000000001
1000000000000000000000000N000001111111111
11111111111111111111111111111111111111111
