NO ./assets/textures/mario/north.xpm
SO ./assets/textures/mario/south.xpm
WE ./assets/textures/mario/east.xpm
EA ./assets/textures/mario/west.xpm

F 220,100,0
C 225,30,0

111111111111111111111111111111111111111111111111111111111111111111111111111111111111111111111111111111111
100000000000000000000000000000000000000000000000000000000000000000000000000000000000000000000000010000001
100011111111111111111111111111111111110000001111111111111111111111111111111111111111110000000000010000001
100010000000000000000000000000000000000000000000000000000000000000000000000000000011110000000000110000001
100010001111111111111001111111111111111111111111111111111111111111111111111000010010000110000000010000001
100010001000000000000000000000000000000000000000000000000000000000000000011000010010000110000000001000001
100010001001111111111111111111111111111111111111111111111111100111100001011000010010000110000000000000001
100010001001000000000000000000000000000000000000000000000000000001100001011000010010000000000000000000001
10001000100100010000000000000000000000000000000000000000000100000110000101100001001000000000110000000001
10001000100100010001111111111111111001111111111111111100000100000110000101100001001000000000111000000001
10001000100100010001000000000000000000000000000000010000000100000110000101100001001000000000001110000001
10001000100100010001000111111111111111111111111111010000000100000110000101100001001000011100000100000001
100010001000000100010001000000000000000000000000010100000001000001100001011000010010000000000010000000001
100010001001000100010001001000000000000000000010010100000001000001100001011000010010000000011100000000001
100010001001000100010001001001111111111111110010010100000001000001100001011000010010000000011100000000001
100010001001000100010001001001000000000000010010010100000001000001100001011000010010000000011100000000001
100010001001000100010001001001000111111111010010010100000001000001100001011000000010000011111100000000001
100010001001000100010001001001000100000001010010010100000001000001100001011000010010000000111100000000001
100010001001000100010001001001000100011101010010010100000001000001100001011000010010000000011110000000001
100010001001000100010001001001000100010001010010010100000001000001100001011000010010000000011111000000001
10001000100100010N010001001001000100010001010010010100000001000001100001011000010010000000011110000000001
100010001001000100010001001001000100010001010010010100000001000001100001011000010010000000011111100000001
100010001001000100010001001001000100010001010010010100000001000001100001011000010010000000011100000000001
100010001001000100010001001001000100010001010010010100000001000001100001011000010010000000011000000000111
100010001001000100010001001001000100010001010010010100000001000001100001011000010010000000010000000001
100010001001000100010001001001000100010001010010010100000001000001100001011000010010000001100000000001
100010001001000000010001001001000100010001010010010100000001000000000010110000100100000001000000000001
100010001001000000010001001001000100010001010010010100000001000001100001011000010010000000100000000001
100010001001000100010001001001000100010001010010010100000001000001100001011000010010000000000000000001
111111111111111111111111111111111111111111111111111111111111111111111111111111111111111111111111111111
