NO ./assets/textures/intra/aumartin.xpm
SO ./assets/textures/intra/eieong.xpm
WE ./assets/textures/intra/aumartin.xpm
EA ./assets/textures/intra/eieong.xpm

F 192,135,134
C 135,134,192

11111111
10101
101001
101E001
10000001
110000101
10000101
11111111
