NO ./assets/textures/lettres/north.xpm
EA ./assets/textures/lettres/east.xpm
WE ./assets/textures/lettres/west.xpm
SO ./assets/textures/lettres/south.xpm

C 255,000,000
F 000,255,000

1111111111
1000101001
1010111101
1000000001
1111111101
1111111111
1111111111
1000101001
1010111101
10000N0001
1111111101
1111111111
