NO ./assets/textures/csadcas.xpm
SO ./assets/textures/csadcas.xpm
WE ./assets/textures/csadcas.xpm
EA ./assets/textures/csadcas.xpm

F 220,100,0
C 225,30,0

111111111111111
100000000000001
101111111111101
101000000000101
101011111110101
101010000010101
101010111010101
100010101010001
111010101011111
100000001000001
10W111111111101
111111111111111
