NO ./path_to_the_north_texture
SO ./path_to_the_south_texture
WE ./path_to_the_west_texture
EA ./path_to_the_east_texture

F 220,100,0
C 225,30,0

11111111111111111111
10000000000000000001
10111111111111111001
10100000000000001001
10101111111111101001
10101000000000101001
10101011111110101001
10101010000010101001
10101010111010101001
101000101E1010001001
10111110101011111001
10000000100000000001
11111110111111111111
10000000100000000001
11111111111111111111
