NO ./path_to_the_north_texture
SO ./path_to_the_south_texture
WE ./path_to_the_west_texture
EA ./path_to_the_east_texture

F 220,100,0
C 225,30,0

1111111111111111111111111
1000000000000011000000001
1011111111111011011111101
1010000000001000001000101
1010111111101011001000101
1010100000101011010000101
1010101110101000000000001
1000101010100011111111111
11111010101011111
  10000W001000001
  100111111111101
  111111111111111
