NO  ./assets/textures/lab_green/tile119_256.xpm
SO  ./assets/textures/lab_green/tile121_256.xpm
WE  ./assets/textures/lab_dirt/tile090_256.xpm
EA  ./assets/textures/lab_dirt/tile089_256.xpm

F 100,85,70
C 210,200,190

        11111111111111111111111111111111111111111111111111111111
        11000000000000000000000000000000000000000000000000000011
        11000000000000000000000000000000000000000011000000000011
        11111111100111111111111111111111111111111100111111111111
        11111111100111111111111111111111111111111100111111111111
        11000000000000000000000000000000000000000000000000000011
        11000000000000000000000000000000000000000000000000000011
        11111111111111111111111111111111111111111111111111100111
        11111111111111111111111111111111111111111111111111100111
        11000000000000000000000000000000000000000000000000000011
        11000000111111111111000011111111111110000111111100000011
        11000000110000000011000011000000000110000110000100000011
        110000001100000N0000000011000000000110000110000100000011
        11000000110000000011000011000000000110000110000100000011
        11000000111111111111000011111111111110000111111100000011
        11000000000000000000000000000000000000000000000000000011
        11000000000000000000000000000000000000000000000000000011
        11111111111111111111111111100111111111111111111111111111
        11111111111111111111111111100111111111111111111111111111
        11000000000000111111111111100111111111111100000000000011
        11000000000000110000000000000000000000001100000000000011
        11000000000000110000000000000000000000001100000000000011
        11000000000000111111111111100111111111111100000000000011
        11000000000000000000000000000000000000000000000000000011
        11000000000000000000000000000000000000000000000000000011
        11111111111111111111111111111111111111111111111111111111
