NO  ./assets/textures/lab_blue/tile065_256.xpm
SO  ./assets/textures/lab_blue/tile070_256.xpm
WE  ./assets/textures/lab_blue/tile071_256.xpm
EA  ./assets/textures/lab_blue/tile072_256.xpm

F 90,90,90
C 200,210,220

1111111111111111111111111111111
1000001000001000001000001000001
1000001000000000001000001000001
1000001000001000001000001000001
100000100000100N000000001000001
1111111110111111111011111111111
1000001000001000001000001000001
1000001000001000001000000000001
1000001000001000001000001000001
1000000000001000001000001000001
1111111110111111111011111111111
1000001000001000001000001000001
1000001000000000001000001000001
1000001000001000001000001000001
1000001000001000000000001000001
1000001000001000001000001000001
1000001000001000001000000000001
1000001000001000001000001000001
1000000000001000001000001000001
1000001000001000001000001000001
1111111111111111111111111111111
