NO  ./assets/textures/lab_green/tile119_256.xpm
SO  ./assets/textures/lab_green/tile121_256.xpm
WE  ./assets/textures/lab_green/tile123_256.xpm
EA  ./assets/textures/lab_green/tile124_256.xpm

F 100,85,70
C 210,200,190

                1111111111111     1111111111111111
        11111111111000000000011111000000000000001111111111
        10000000000000000000000000000000000000000000000001
        10011001100000011001100110011001100110011001100111
        10011001100010011001100110011001100110011001100111
        11100110011001100110011001100110011001100110011001
        11100110011001100000011001100000011001100110011001
        11111111000011111111110011111000011100111111111111
        11111111100011111111110011111111110011111111111111
        10011001100110011001100110011001100110011001100111
        100110011001100110000001100110011001100001100111
        100000000000000000000000E0000000000000000000000111
        10000000000000000000000000000000000000000000100001
        11111100111101111100111100111100011111111100011111
        11111100111100111100111100111100111111111100011111
          10011001100110011001100110000001100110011001100111
          10011001100110011001100110011001100110011001100111
          111001100110000000000110011001100110010000110011
        11100110011001100110011001100110000001100110011001
        10000000000000000000000000000000000000000000000001
        1000000000000000000010101100011000000000000000001
        10011111100000000000000000000000000000000000000001
        11111111111111110000111111111111111111111111111111
        11111110011000000000110011001100010010000010011111
                 1111111111111111111111111111111111
