NO ./textures/NO.xpm
SO ./textures/SO.xpm
EA ./textures/EA.xpm
WE ./textures/WE.xpm

C 50,50,150
F 150,150,50

11111111111111111111111111111111111111111111111111
10000100100000000000100010000000000100100001000001
10110100000100111001001000111110010000010100001001
10000110010110000100001000000001100101000101110001
10100001001001010101100111110010000101100110001001
11000101001000010010001000000000010100010000100001
10001000100011101000001001001101100001001010010101
10100010010100000100001010100010001010001010000011
10001001010001110010010010111000010001100011101001
11001100000000001001000010000010010010011000000101
10000010001111110000100000011100101000000011101001
10101101010000000110011110000001000101100100000101
10010000000110110001000001100001010100010001101001
11010010100001001101100100001001010111001010000101
10001010010100100000011010010010010000010000001001
10010001010010100111000001010000101111100010001001
10010010010010101000111101010111000000001010010001
10100001010100001010000000010000000010100010010101
10000010010001100010010011100010100100010010100011
10000100011100010000101000001001010001010100101001
10100101100011001001001000101001001010010101000101
10010100001000101010010010100101010000100100101001
10010110110010001001000000100101000111001000001001
10100001000100010001010001010100101000000101010001
10001001010010001010010101010010010001010010010101
10001001010001001010010101001001000010001000100101
11000101001000101010100100010101010001100100110011
10011000100100101001000100000101101100010000001001
10100010010101000000010110110100000011010011100101
10001000010000111011100001000110001000101000001001
10110100001010000100011000001000100010000101000001
10000101001001110101000010000010010101100101011101
10011001010100000001111010111001010100010101000001
10100001010011101010000001000101010000010100111011
10101110010000000101000010010100000110010001000001
10100000010001010100001100100111000001000100100101
10001001000001000010010000101000111110000100000101
11001000011110001001010100100010000000011110010101
10101010100001000101010011010000100010000100001001
10001000101001001001010100011010100100100000110001
1N000010000100010000100110100100100000100111000001
10100101010011100100010000010100101001001000011001
10001000101000010101010001100100010000001011000101
10000110000110000000100010001011001010001000101001
11010001010001001010101000100000001000010010100001
10100101001000100000100101010011100001100010010001
10001000010100010101000101000100011100000001000101
10100111000010100100001000111001000010100110101001
10010000001000000100000010000001000000100000001001
11111111111111111111111111111111111111111111111111
