NO  ./assets/textures/north.xpm
SO  ./assets/textures/south.xpm
WE  ./assets/textures/west.xpm
EA  ./assets/textures/east.xpm

F 140,110,80
C 170,200,230

1111111111111111111
1000000000000000001
1000000000000000001
1000000000000000001
1000111110111110001
1000100000000010001
1000100000000010001
1000100000000010001
1000100011100010001
1000000W11100000001
1000100011100010001
1000100000000010001
1000100000000010001
1000100000000010001
1000111110111110001
1000000000000000001
1000000000000000001
1000000000000000001
1111111111111111111
