NO NO.xpm
SO SO.xpm
EA EA.xpm
WE WE.xpm
C 150,150,150
F 200,200,200

111111111111111111111111111111111111111111111111111111111111111111111111111111111111111111111111111111111111111111111111111111111111111111111111111111
100001000000010000000000000000000000010000010100000101000000000010000010000000000001000101000100010000000010101000000000000000000000001000100010000001
100100001010000100010010010011100011001001000001010101001111100000111000100100100100010000010000001000100100000011000000100010010111110010101000001001
100001110001001000000100101000011000100000001010010101010000001101000001010111000010001111000110010001000100010000010101010001100000001010101000010011
111010000101010011000101000101000100010101100100100101001000100001010010000000001010010000101000001110010100100111000000000010001100101010100100100001
100010110001010000100100010100100001000010001000101000100100111000010100101010010000101010101000010000100100100000110011101100100010001010010010000101
100100001000000100110010000001011101000010001001000101000100000101000000100100000010000100100111000111000010100010000000010001010001001010010101011011
101000100111011001001000101110000000111100100010000101010000010000111011000101111101110000110000110000100100101001001011000110001001010010100001000001
101001000000100000100000100000100001000010010100000001001101001001000100001010000000001110000010000010000010001010100100001000101001001010000100011101
100000000010101001001110001110101001001000100101111001010001110010010000000000111111100001000101001010011111000010010000010011001001101000100011000001
110100011010101000010001010000100110010001000100000010010010001001001010011100000000011100100100101011100010010000001011100100001000001000111000101011
100101100100100010010100100011001000010100011000000100010100101100101001000011101011100010010001000100001010101101100000001001110010001011000100100001
101000000001010100100110010100001010010010100011111000100100100010100100101000010000001001011010001001001010000010010100110010000100110000011000100101
101110011110000001001000000101010010010100101000000100100100010010101110001111000100001001000010101000001000100010000111001000110010000011100010010001
100001000000111100001000111001000010100101000011110010010001000100100101100000010010100010000100010101101010010100111000010111001001001100001100010001
100100100110000011110001000011100001000100100100001000010000101001000100011011001010010001000001000010001011100100000010100000010101010001010001001011
101010001001110000001110000001001001001110010100100010001110100000100010100100101011100101101001101010001000000100000010000100000101010010100100101001
101000010000001000100000011110000100100101000101000100100000101010101000100000101000010100010010001011100111001010101001001010111000010000001010001101
100101100010100100000000100000010010100001111110010010110011010000100110001000001001010111100010100100010000010000010010110010000111100001000001000001
110100010100010101011001001000101000101100000100001000000100000100001001010101010001010000000100010101000000100001000100000001100000001010010001011001
100001000001001000100010101111000100010010010000101011000100100101110001000010000100010001000101010100100100000010000010100010010010110001001001000101
101101001110101010010000100000010010000001100101001100100110100100001000111010010010100110110010001000110001001000001000111100010010001010100001110101
100000010000001001000101110000001001101100011001000000010000100101010010000010001000101000001001010010001000100101110001000000000100100100000100000101
101000100011101100111000100100010000010001000100110111001001000010010101000011100101010001001000010100100001000000000001001111001001000001000011000001
101011001100000010000000101001100100011001000100001000100100010100010100100100010010001010100011100100011010001101000001010000100000010010001000101011
100100100001000111111111000010000010000010011000100100000010001001010010001001001100101000110100001000100100010010000110000010001110011100001000001001
110000001010011010000000100100101001100010100001010010111001101010001001101000100001000101000100100100000101010001010000010001010000100000110011101101
101000001000000010100111011001000100010010001010001001000100001000100100010001010010010101011010010001100101000100100111001010010010000110000100010001
100001000100111100101000000101001111001101000000101010010010000110101011001010011010010001000001000010001000110010001000100100010001101000011001000101
110100110010000010100010010101000100100000100000101000011000101000101000100000100100001001001001110010010001001000010010011001111000001000100001100001
100010001010001000100100010100010000010010010110001001100100110010001010100011000001001110110010000100010100101010000101000100010110100001000010001001
101000101000011100100001100001101010101001000001010000001000000101001010110100010000000000000100100100100010001001100101000111010000011110000010101001
100110000111001011001100000000000010000100001101001111010001011000001010001001000001101111101001011010101001000100001001010000011111100000100100101001
100001001000001000010000111100011000100100010001010000010110100001110001000101001000010000001001000000000101001000000001010010100000000100011001010001
100101101001100010010011000010000101001010010101000100100000010010000101011000100101010001010100000101111001010000011100001010100000001001000010000011
101000001000011100000000010010100100010000010001011010010111010010010001000100010100100001000001111000000001000000100010101001011111001000100100110001
100100100110000001111111100000010101000001111000100001010000010010111001110011010001000000100100000000010000111001010100101100000000010011000101001011
101111000001111010000000001010100001100010010010100100011001101010010110001000010000111110010101000000010010000100000100100000011001101000101001001001
100100000100000001000100101001001000000100000100100111100010000010010000000010001000000001010010000111101001010100111000100010100000001010001010000101
100100110011010000110010011101000010000100111010010000001000101000100001001100100110111010001001000000001010010001000100010100001001010010010001011001
100101001000100001001001001001001000110101000010010011101100010000001000010000010001000000100100100111010010111010010001100001001110000100000101000001
110001000110100010001000100010010011001001001000100100010011001000000110100111000100010101000010111000100010010001000110001010100001101000101001000011
100010010000001101000111010100100100000100100100101001000000101100011001001000010001000010000100000010001101010001001000100010011100010010100001001001
100000010101000001010000001001001001110010011011001010000000100001100000001010001100101001000101010100100000010000101000100100000010000101000100000011
111111101001011001001110000001000010000010000000001010111000100010000111100010100000100100000000101000010101101110001001000100110100011000100011100101
100000001001000010010000011110011100000100100010010001000110010010101000001010010000001111011010100011100010000000110010111010001000100010001000010101
100010110001000100100001100000100001000100011011000101010001011010101010010001010101100100100100111000010001100110000010000000101010001101000001000001
100100001010100001000010001000000000000010100000100001000101000000110010000100010010001000100110000101001100000001000100010001001001010000010010001001
101011001010001010001100101110011110100001000110101001000101110101000111110100101001010000000001010110100010011100010101101110010010010010100100101011
101000100000000100010010010001100000011100010001000001010000000001001010000100000100100111010100100000011001000011010100000001000010100100100100001001
100100001110001000000010010100011111000011001100010101001000101010010001000101010101001000101010101100000100001000100100101101010010000100011001000011
110101010001101001110011010001000000101000100011000110010011001000100100010001000101010001000000100001100010000010100010010001010011100101000010010001
100100100100001010001000010010001010000010101000010000010100100110000010100011100101001010000010010010011000010100010011001000100100000100101100010011
100000101001010001100000001010000101000010010010001001000100001001000100100101000100101000100011000000000111001000101000100110000000010010000010010001
100000100010001100011111010011010000111001001101001000100100110100101000100100010100101010000100001111110000010000001110010001010011100001001001011101
100011010001000011000000001000100101000100100000100101001001000010000100100010011000100100001001000000001000100111000001001100001100001101010010000001
100100001100100000100110010100001000010001000010101001010010010001110000101001000000110001000010001110000100010000010001010010100010010010010001111111
100101000010011010101000100010100000100100011000101010000001010100001010010100000110001000011101110001011011010010100010010010001010100000010110000001
100101111001000100110010001001011001000010100100010010010101010010001001100010011001110011100000000101000000010010000100100011010001000100010000000101
110100000100010010001001000100000000011000100001100101010101100001001010001010100000000100001000101001110111001001011000001000010010001000100011100101
100110010011101001000100100011110000100101001010000100010100000101100010010000101011111000100010010100001000100101000111111100000010010010000100011001
100000011000000100100110100100000001000100100010001000100010011000010001010100001100000000010100010011001010110010100000001010010010100001001001000101
100001000110010010010000010000111010000110010001010001000101000001001010010000100000111000100000100000100010001000011001001010111100100100000001110101
100111101001001001001011101100000100100000100101010001010001001000100100100011010001000001001000010101000101100111000010000010010000101011011000000101
100001000000101100100100000000101000011110010010010001001110001010010010010100001001010100000101000100000000010000111100111001000010001000100011011001
101101000010100010100001111001000101100000100000001000100000110010001000001001100000100010100101000001010111010100000001000100010001010001000000100001
100001011100001000011100000001010100001100011010101100000010001010100111000010000100000010100100101101011000001010010010010011000110000100111110100101
101001000001101100100010010000010010010000100100100011110100010010010000011100100010000100110010100010000010100010001000001000101000110100000000100101
100100001100010001001000011001010000100100100100001000001001010101001010100010101001111001000010111001000100011000010010101100001010000111000100110001
100110010010000100101100100110010101000110100001100101100100100000100010001000110000000010001000000100110101100111001000100010010011111000111000001001
101000000010101111000000100000100010001001001000010010010100001110010001001000000100011101001110100010001000010000000100100111000000000010000111001001
100000111100100100001111001011000001010000010010100010010000100001000010100101111111100000000000011001000001010000111000010010010110010011100000100001
110010000010101001010000001100011100010100000100000000100010010000111000010100000100010010110101000100110010010001000000101010010001001000010010011001
101001010010101000100101110001100010100101000010101011000100100111000001000111110001001100001000101010001000001101001101000000100100101001001101000001
101001010010010100101110000010001010101000101001010100000100010000011000110000001000100001000010100000101010110010010001010000000010001010010001010101
100010010001000000100100011000110010100110100101000100111010000100100111000000100010111000101000111110100001000001010001000110100001010001010100100011
100101000101001001010010100101000100010000010001010101000000111001000000001110001001000010011111000000111101001100010001001000011101001010000110001001
100100101001100010001010100101000011000101001001100100011111000000100111100001010010010101001000001001000010010000101100100010100001101001001001001101
100110000100010100101000001001111000101000110000000100100000010100101000000001010100101000100001100010011010100001000011011001001010001001100010010001
110001010010001001000111010010000110100010000010101000101011000010001001000010001001000110001110010010100010010001001000000100010010110010011000100101
101100001001000001001000100010010000010010010100010000101100101001010010010010010010010000010001000100000101011110100010110000001010000010000101000101
100010110000100000100010101000011110000000100111100011000010000101001100100011001001100101100100001001001000000000001001001000101001000100100001011001
101000001110010010000000001110100001000001010000000100001010010001000010101000101010001000000001000010001110010001000110001001000100011001001101000101
101000100001001001111001010001000101100001001110011010110010100010001010100110001010100100011110010000100001100010001000101101001000100001110010110011
110010100001101010000101010100100100011101100000000001000010101011101010001001101000100011000000101100111000011001001011000001001000001010000000001001
100111001000001010011000010010010101000000010101100100011100001000010011110000000110011000100100100001000110000110110000010010010111000100011101100101
100010001001010000100011100101010010001001010010001010100010000111010100000011010001000110001010010001010001110000001001001000100000100100100010000001
100100010101010101001000010101010010100010010000100010001010010000000100111100001000110001110011001110000100001110000110001011001100101001001001001001
100100100001001001000010010101000100010100101111111000010011001110000101000011100100000100001000100000110000100001110000100100000010001000010101000101
101010010000100111111001010100111010010100000000100010100100100001011000011000010011000100101001011010000101000100001001010101000111110010010001000011
100001011110010001000001010100000001010111011110011001001000010100100100100101010000000101001000000100011001000000100100000100100010000101001000101001
101101000000101000100110010101010001010000100000100110001001000100000011000101001000100001001000101000100010011100100110011001001001010000100010100101
100000100000100110001000100100101001010010100011000000010010010111011000000000101000001110000111001001001100100001010000100001000100001010011100110011
110101001100010001001011001010100100010100110000000111100100101000100100000001000110010001010000001010010001011000001001001000101010101010000001000001
100101010010010010001000001000010011001010001011001000001000001010110001111100101000100100101011001001000100000001010100010001000001001010011110100011
100010010100101001110100010001001000001001100100110001100000010010001010000000101001000110000100010100000000111001010111100010000110001000100000001001
101000010100100100000010010000100110010000010100000010010010101010101000011001001010000000010010100010111110000110010000000011001000101100100110010001
100100100010010010101000101101000001000011100101101001000001001001000011000101010000110010001000101001000001110000100100111000010010010001000001010001
110101001001001000101000100000110101011000000100010101010001001001010100010001001110000001110000010000100100000101000010000100010100100010000110010011
100101010010001000100100100001001000100101001011010000011110001001000111100010010001000110000011000010001001001010011111100101100101000100001000010101
100100100100110000010110100010001001000001010000010000000000100101001000000000010101001000100100100100010000001001100010010100010010001000110001100101
101001000101001000010000001100101010011110010111000011110010001001000011010000010100100011001000100011001010001000001010000100001010100101000010000001
1010100101001001001001010100101010101000000100001001W0001001110000001100001111100010001100000100010000101001101101010010010011100010011001010000011101
101010001010010100001001010010101010010100100010100100101110000011100010100000000101010001010001010110100100000001010010001100010010100001001111100001
101010100000100010000100000000100001010010001100101001000000111000001010000111111001010100001110001000100010010010010100110001001010001110100000011111
100011001000101100110010101010111010010010100010010010011001000101010001010000000010010010000000101000111001010000100010000100100101100000001101000001
110000100111000010001100010001000100100010101001000010000000000100010001000111100100100001111111000010000101001111001010000010010000001000110010111101
100010110000101011010011010010010010100010010010110010011011000101000100111000000101001100000000000101110010100000101010111010010011001001000000000001
101010000110001000010000011100010010000000100010000000100100011001110010000010101000100011101111001000001000010110101010000000000100110010010111111001
101100001001000100100100100001100100010101001000011110000001100000001000100100010010010100010000010001100010011000101000111011010100000010001000000101
100000110000010100100010101000000001001000000111100001111010001011000101011000100001000001000101100010011001000011001001000100100101111000110010010111
101100001100100011001011000111110000100111111000001100000100001000110010000000100101001010000100001010100100110100001000010010010100000101000011000001
110000100010000100001000010000001010010000000010010001100000100001000010010101001001000001101000100000100011001010100000001001000110010100001100100101
100101000010010100101001001111001001010010010010000010010011010110010000101001010001100100010011010110101000001000010000110101001001100010010000101001
100010011100010100101000100000100100010010001000101001001100010000100101000010001000010011000000001000100111101001001110000101000100001010100010001001
101100100010010100000011000110001000100010010001001000000001000110000100100011001001001000100001101001001000001001100001010100100010010001001101010001
100000110010010101011000010001001000010001000100001110111101001000011010010000100100100110011110001000001100110010011100010010010100100100010000010101
101001000100010001000101001101000111000100110010110001000001001000100011001110110010010000100000010001010000001000100000101001010000100101010001100101
100100101001100010010101100001010000111010001100000101100000001000101000010000001001001111000101000010100011001000101000100100001001000010001010001001
110010001010000100100100010100010010000011000010100100011110000101001100001000001100100000011000111100001000100101001010000100101101010000100100100001
101010100010001000000011010101010000111000111001000001000001010101000010100110000010010000100101000010100100010100010000010101000001010110100000111001
101010000101010010111100010001010001000100000100110100011101001001001100110001100001011001000001001010010111100010001110100100011010001000011100000011
100011100100000001000001000010010001010010010010001000100001110010010000000100011001000101011110001010010000000101000001000011000000100100100000010001
100100010100011010001110001100010101001011101001101001001000000010010100110111000100110101000000100010001001100000011000010000110000101001001101000101
101000100100100100010000010000100101000100000100000001110010010010010101000000010100000100110010010011000110001001100111001101001000001100010000101001
101010010101000100100000010011000101110001110010010100000010011100010001001000100111001001000001010000101001010010010000010010001110010011000001000011
101010000101010001001010010000010100000110001001000111011000100000001010000101001000110010001010010101001010010010001001000000100000100000100010011001
101001001001001110001000001010001110000000010000110000100001001001110001010010001010000100100010100101010001000010100100100111010000101100100100000101
100101001001000000100100000100100101001111010101000100101110001010000100010001010001001000111100010010011000111010100010101000010011000010001001100001
110100000100100010010011100001010001010000010100100100100000101010100010001100010010000001000001010100000010000010101010100101011000101010010010010001
100011010001000001000100010010001000010010100110111001011101001010010000100011001010010010011100010001000001001100110011000001000100010010000100100111
101000100010011110001001001010100100000100010000000010000010001001001100001000110000101001000001100010000100010010000000010001110010010101011000101001
101110100100000000101010101010010000110011010101100100111010010001100011110110000011000100110010001000110010100000100111001000001010000100100110100101
100000101000010000101010000100101001001000001000011001000000101010011000000001100100010001001010000010001001001001001000101010101000011010010000101001
110011001010101011001011010000100101001110100101000100110000001001000101100100010000100010001011111000100100001010001010001001001100100001001011001001
100100000100100000001000100111000000000000100101010001001010100000000010001001001010001000010000000010010011000010100001001000100000101100100000010011
101001001000100010001100101000010011111100010000100110000001000011001010000001001001000110001110010100001000101000010100001010011111000010100000011001
101000001010111001100010100011101000000010010011000000110010001100100100001000101010101000110001000100110010001011010011110011000000010100100111000101
100111101001000110010010000000000011100001010100001011000100010010100101000111001010001001000100100111000001000000010100000000101011000010100000110001
101000000010010000000010011111110100010101010001001100100001010010000101001000010010000100011000101000010100000100100111100010010100100100010010001001
100011011100101111011010000000000000010101001000100010011110000001011001010010010101110010100001001001010010100101001000001101000100101000100100010011
111100000001000000100010001000101101010100010010010010000000111100100101001000100100001000100010010000111000011000001011110000001000101010001000001001
100010101110000000101001010010100010010010010100100100100110000010100001101100010001000110001001000110010101000110101000000011100010101010010010010011
100100010000110000101000010100010010101010011000101001001001001010101000000001100010001001000100101001000100100000101001001100010100010001001001010101
100101001001000101001011010000101010101010100000100100010001010000001111000100010010100000011010001000111000010111001010100001000101000101001100100001
101001100101000010010100000100001010101010000100010010100101000111010000100010001010011111000001010010000001001000001000010100100000100101000010011001
100100010000111100010000101010110010001011111010100100101000100000100110111100100010000000100100001001000010101000110000100100100010101000101001000001
100111001100000010011100010001000011001000000010010011001000100110001000000000111100100010001010001010011100001001000111001000111010000101010010010001
100000000010001000000001000100010000001001001000001000010000001000000000000000000000100000000010000010000001000000000000001010000001000001000000000001
111111111111111111111111111111111111111111111111111111111111111111111111111111111111111111111111111111111111111111111111111111111111111111111111111111
