NO ./texture/NO.xpm
SO ./texture/SO.xpm
EA ./texture/EA.xpm
WE ./texture/WE.xpm
C 100,100,100
F 25,50,200

1111111111111111111111111111111111111111111111111111111111111111111111111111111111111111111111111111
1000100000010010100000000000000100000001000000100000000001000000010000101000000000000000001001000001
1100101011001000001000000100010001001001001100000101100100001110010010000000000100101000100100001011
1001001000101001000011001001000010000000000001100010001000100001000011100110001000010010000101110001
1010010110101010010000100001001010010111110010011000110001000101000100001001010001000111000110000101
1000010000001010010110010110000010101000001010000101000100011000100101010001001000101010010000110001
1010000001010001100001001000100100101011000010100101000011100010100101000101000010010010001111001101
1010001110000010000010010010010001001000100010010001000100001000100100111000001101001000010000100001
1010010001001000111010100010011111100100010011001000001001001000100101000010010000101000010010101001
1011000100100110000010011001000001001010010000101100100100010111111000101100100100000111100010110001
1000101000010001000001000101001001001010100100100001110001010000100100100000000111111000000010001101
1100101110001000111000100100110101000010100001001000100010011110000010010100001000000011100101100011
1001000000100010000100010101000101010010000100001010101100100001001001001001100001001000001000001001
1010010101000001110001010001001001000011000101001010100010101000010100100100010010110001001010010101
1010001001011100001010010000010010001000100110010010001010101111100110010100111010000110001001000001
1100100010000011101011001101100100101111010001100100101010100000010000100101010010010001000100111101
1001000000001000010000100010001001000000001100000100010010100001000100101001010000101001010110000011
1010100101001001001110010100100010011100100001110000100100100100100100001000011111001010010000001001
1000010010011110100001000010000101000011110010000010100101011001000111110110100000001001010111110001
1001001000001000010001001001010000110000100100100101001001000001011000000001000100100100010000000101
1101100111100010010101001110001100000100100100001001010010010101000011111100001001000001001001000101
1000010000011101010100100000010010010011001110001001010010100001000100000010010010111110010010010001
1000100011000000100011011101001000101100000100010010011000100000101000001001010100000000100100101001
1000000100100010001000000010101010000001010100100001000110001110010001100100100101000101001000000011
1000001000010100100100111100001000100110100100100100110000100001000110000100101001001010010101010001
1000000101001001001010000001100001000000010010001001001100100100111000011000100001100010100000100101
1111010101000000001010000010000010100011001011000001010000001010000101000010000100010100011100001011
1000001001111111110001110000010010001100101000101001010100000011001001000100011001001001000010010001
1010010010000000000010000101100010100001001000100010010111111000100100000010000110100100101011011001
1001100100111001111100100010001010011010010000110010000000000100010110100001010000010010001000000101
1010010000000110000001001010100001000010101111000101001001100001100000111100100010000101100110010001
1000000101001001010010001010010100101010000000011000100110010110011001000011001001010100010000100011
1111011000100100010101000100100010001010001000000100001000001000000010101000001000100101001011001001
1000100010010111010101001001010100010010010100000101010001100011000010001111000010100000100000001001
1010001100010000100101101010010101100100000110110001000010011000001010010000100100010011110001000101
1010010000011110000100001010010010000000110001000100010000100010001011010101001000100100100010001001
1011001111100000000000100010100100110001001100101010100100101000010000010100000010000000101010100001
1000110000001000011010010100101001000101000010010000100101001001100110001010111100100000001010011111
1010000111100101100001000100101100001010011001000110000100010000000001010001000001001111001100000001
1000111000010010001001111000100010010000100101010001011000100100101110010100010100010000010011111101
1001000000010100100100000000001000010010000100100101000001000100100000100011001000000010100000000001
1000110100010100010010100111001100010100101000101000011100000100001110101100000111111100001110111001
1110000011000101100100101000010010000101001010001001000001010101010001000011001000000011100001000001
1000111100011000010100100000100101111001001010001000101010000101000100111000101010110000010010010011
1111000000100010011000010010101000000001010001000010001000000100111010000010110001001001010010010001
1000011000101001000011100100101000100001000010001001001010010010000001110010000000100110010101010101
101000000000110101110000100010011001111010001010010100010110110010010000010101111W001001010000001001
1010100111100001100001000100110001000000010010010101010000000000010111000000100001001001010010000001
1010110000010010001110100010001010000001010001001001011001100101001000100110001100100010001101100101
1000001001010100110000001010001000111101010100010001000010010100010010001000110010011100100000011001
1001010010010100000011001000010001000001010010010000100010000100100101110001000101000000100001000001
1001010100010101000100010100100100001110010010111110000010011000000100000100001000111100100001110101
1100100100100100010010000010011010010000010100010001100100100001111001001010101010000010100010000011
1001000101010010100100110001000000010010101001010100010001000110000100010000010010001000010000101001
1010001001000100101001001001100110111001000001000111001110101000110010100101100010010101001000100101
1000010010100001000101000100011000010101010100100000100000001001001000001000011010000100001000100101
1111010100000000110101010001000100100001010010100000111001001010101110010011000000010010110001000101
1000100001000111000100001010110100101000100100001111000101001010000001000000010000111001000000001001
1000011101010000010000101000000100100100000101000000000010001001000100101000011100010100111111000101
1011100001001010010010000100000000110010101000011101111010100100101001000001100010010010000000001001
1000001011110010000101010010011110001010010010000010000100011000100001010100001000010011101000100101
1001000001000100110000001000100001001011010100111000110001000010010110010010010100011000000001011001
1001010010011001001011110100101001010000010001000100001001010000000000001000010011100010010101000001
1010010010100000001000000001000100010001100001010001100010011000001100000110000100000100100100011001
1010010100110011100001001000011010010100010010011110010001000111000011001001100000110000101011100001
1010010000001100011101010011000000000101001000100000010101100000010100110000001101001000100000010101
1010111001000001000000100100100111110000101001000101100100011110100100000100010010100101000101010001
1010010100100000110110000001001000001010010010100100010101000000111001000000100000000100001010010001
1011000010010100001001001001010101100001010100001111000010100111000010001010100110010000101010100011
1000110001000100100001010010010000010100100100010100101010010000001101001010011001011111000010111001
1001001001000100010110010100101010100000101000100000101010000010100000010010100001000000001100000101
1001010000100011001001001000100010010000100001011101001011110010101001000000001001001100010000010101
1001010101001000110001101010001100100010010000000001001000001010010001100101110101010010010101100101
1001000101001110000100001010100010101010100011110001000111100101000100010100000000010001100100000101
1001100001010001110000001010011000100100010100001010011000010000010011000100111010010010001001110001
1010001001000100001001000011000110010000100010101010000001001100100100000110000000100000110110001001
1000010010110010101010010000110001001001010010010010100010100010000101011000010000001110000000100101
1001100100001100101011100010001100010010001001000010010100010001000000100110010110100001001111000101
1110000101000001001000000000100010010010100100101000001000010101110010010000001000100100010000110011
1000111001011100011111100001001001000010010010100100100101010000001001011001101001010000100010001001
1001000000100000001000010100010100100010100100100001110100011001101000000000010000001101000001000101
1001001010011111100000100101000010011001000100001100100010100010001100101111001001100000010010010001
1010010001000000010000010010001001000100100110010010000100101000000010010000101010011001100100001111
1010010100010111001111111001010000010100101000100000010001000111110011010010001001000010000010110001
1000010011001000100000010100100101010010101010011000100100100000000000011010000101100000101010000101
1000100100000000100110000000101000111010001001000010011010011111000100100010010000010111001001111001
1001000010011110000001101010001000010011110010011010000001000000101001001001000001010000100010000001
1100101001100001000100010100100101000100000100100001111101001010101101010000110110000010010010101011
1010100100001100110001000101010100100101000010100010000001010000100001001100001000100100100100010001
1000000010010010001001001001000010101001010000111100001001010100110010010011001010000100100001011101
1000110100100000000100100001001001000001001001000000100000000100001010100000001001111000010101000001
1011001001001110000010001110100100111001000101001000011100100100101010101011101010000011001001001001
1100000000010001101000100000001010000001010001010101100010001000010010101100000010010000001010010011
1001111100100100010001001111001001011001001010010100001011000101010010100011110101001100010001010001
1010000010010001001100010000101001000100101010100111110000010100100100101000001000100010000101100011
1000011011111001100010000101001000110001001010100000000100001001000100000000100010101001111000000001
1100100000010010001011110000101010001010010010001100010010100010001011011110011100101010000011111101
1000110001000011001000001111001100001001010101010010100100100010110000000001100001001010111000000001
1000000100100000000100100000000001000100010000000000100010000010000010000000001000001000000100010001
1111111111111111111111111111111111111111111111111111111111111111111111111111111111111111111111111111
