NO ./assets/textures/mario/north.xpm
SO ./assets/textures/mario/south.xpm
WE ./assets/textures/mario/east.xpm
EA ./assets/textures/mario/west.xpm

F 255,204,225
C 135,206,235

11111111111111111111111111111111111111111111111111111111111111111111111111111111111111111111111111
10000000000000000000000000000000000000000000000000000000000000000000000000000000000000000010000001
10001111111111111111111111111111111111000000111111111111111111111111111111111111111111000001000001
10001000000000000000000000000000000000000000000000000000000000000000000000000001111000000011000001
10001000111111111111100111111111111111111111111111111111111111111100001001000011000000001000000001
10001000100000000000000000000000000000000000000000000000000000011000010010000110000000001000000001
10001000100111111111111111111111111111111111111111111100111100001011000010010000110000000000000001
10001000100100000000000000000000000000000000000000000000011000010110000100100000000000000000000001
10001000100100010000000000000000000000000000000001000001100001011000010010000000001100000000000001
10001000100100010001111111111111111001111111111110000010000011000010110000100100000000011100000001
10001000100100010001000000000000000000000000100000001000001100001011000010010000000000011100000001
10001000100100010001000111111111111110100000001000001100001011000010010000111000001000000000000001
10001000100000010001000100000000000000001010000000100000110000101100001001000000000001000000000001
10001000100100010001000100100000000000100101000000010000011000010110000100100000000111000000000001
1000100010010001000100010010011111111111001001010000000100000110000101100001001000000001110000001
1000100010010001000100010010010000001001001010000000100000110000101100001001000000001110000000001
1000100010010001000100010010010001111111110100100101000000110000101100000001000001111110000000001
10001000100100010001000100100100010000000101001001010000000100000110000101100001001000000011110001
10001000100100010001000100100100010001110101001001000110000101100001001000000001111000000000001001
10001000100100010001000100100100010001000101001001010000000100000110000101100001001000000000011001
10001000100100010N01000100100100010001000101001001010000110000101100001001000000001111000011100001
10001000100100010001000100100100010001000101001001010000000110000101100001001000000001111110000001
10001000100100010001000100100100010001000101001001000001100001011000010010000000011100000000001001
10001000100100010001000100100100010001000101001001010000000100000110000101100001001000000001101101
10001000100100010001000100100100010001000101001001010000000100000110000101100001001000000001000001
10001000100100010001000100100100010001000101001001010000000100000110000101100001001000000110000001
10001000100100000001000100100100010001000101001001010000000100000000001011000010010000000100000001
10001000100100000001000100100100010001000101001001010000000100000110000101100001001000000010000001
10001000100100010001000100100100010001000101001001010000000100000110000101100001001000000000000001
11111111111111111111111111111111111111111111111111111111111111111111111111111111111111111111111111
