NO  ./assets/textures/tile/tile106.xpm
SO  ./assets/textures/tile/tile104.xpm
WE  ./assets/textures/tile/tile105.xpm
EA  ./assets/textures/tile/tile102.xpm

F 48,48,48
C 206,206,206

111111111111111111111111111111111111111111111111
100000000000010000000000000001000000000000000001
101111011110010111101111011101011110111101110101
100001010000000100010001000001000010000100010001
101101010111110111101011011111011011110101011101
100001010100000000010100010000010100000101010001
101111010101111111010111010111110101111101011101
100000000100001001010000010100000100001001000001
101111110111101101011111010101110111101101111101
100010000000001001000001000100010000001001000001
101010111111101111011101110111110111101111011101
100010100000001000010001000100000100010000010001
101110101111101011110111101011111011011111110101
100000101000001010000100001010000001000000000001
101111101011111010111101110101111110111111110101
100000001010001010100001000100000001000001000001
111111101010101010101111011111011111011101011101
100000101000101000000001000001010000010001010001
101110101111101111011111011101010111110111010101
100010100000001000010000000101010100000100010001
101010101111101011110111110101010101111101111101
100010101000001010000100000100010100000100000001
101110101011111010111101111101110101111101111101
100000100010000N10100001000001000100010001000101
111111111111111111111111111111111111111111111111
