NO ./assets/textures/black/black_n_256.xpm
SO ./assets/textures/black/neon.xpm
WE ./assets/textures/black/black_w_256.xpm
EA ./assets/textures/black/black_e_256.xpm

F 0,0,0
C 0,0,0

1111111111111111111111111111111111111111111111111111111111111111
1000000000000000100000000000000000000010001000100000100000000011
1110001111000110100111100010101010110010111011101110101110111011
1000101000000010000010001000100010001000001000101010000010001011
1011001010100111110110111111111010101011101010100011011110100011
1000100010001000000010100000001010000000000010101000100000100011
1110101111100010101010101010101010111110111010101110100111111011
1010001000101010001010100000101010100000100010001000001000100001
1010101010001010111010101100101010101111001000101001100011001111
1000000010001000100010100010100010101000001010000010001000000011
1011100110101010101010111110101010101011110011111010101011111101
1010001000100000001000100010100010100010000000000010001010000001
1010001011101111110111101010110110001010111011111111101011101011
1000001000101000001000000000100010101010100000100010001000001011
1010101110000011001011111111101010001010101110101010111001111011
1010100010101000100000000000001000100010000000101000000010000011
1010011000101011101110110011101111111111111101101111100000110111
1010100010100000001000100010000000001000000000101000001010100011
1010101110101110111001101010101011100011001110100010111010101011
1000100010000000101000101000100000100010001000001010001000001011
1011111010111111101110101111111010001010110011100011101111111011
1000000010000000001010100010S01010001000100000100010001000100011
1110111011100110101010111010001010110010101110111010101000101001
1000100010000010100000100010000010001000000000000010100010100011
1010111010111010111111011110011101101010111011101000101010101011
1010001000101010100000000000100000000010100000101000100000101011
1000101111101010101111101110101011111000101110100010101001001011
1010100000100010101000100010001010001010000000100010100010001011
1011111011001110101010111001001010101110101000111000101110111011
1000000000100010100000000010001010100010100010001000100000100011
1010101110011010111111101010001010111011101111101011101110101111
1010000010100010001000101000001010100000001000001000001000000011
1001111010101111100010101111101010011110101010101010111111111111
1000100010001000001010000010000000100000100000000010000000000001
1110101110111010111111111110111111101111001111101111111011101011
1000001010100010100000000000100000101000101000000010001000001011
1011100010001010001111111111001110101010101010011010111111110011
1000101000001010001000000010001000101010101010001000100000000011
1111101110000111110000101010101001101010001001101111101010111011
1000001000100000100000001010101010001000001000001010001010000011
1000111010100100101011111010101000111010101010101010111011101011
1000101000101000101010000010101000100010001000100010100010000011
1010101011100010101010111110001011111111101011110110101110000011
1000100010001000100010100010000010000000101000001010100010001011
1011111110111110110011101010110110101110101011101010011011101011
1010000010101000000010001000100000000010101000101000100000101011
1010111010101010101110111011010011110000101010001011100110101011
1000000000101010100000000010001010001000001000100010001000100011
1000101000101010000111111000101011001011101111101100110011111011
1010001010001000001000000000100010001010000000000010101010000001
1010110100101111101011101111100110101011111110000010101010111011
1010000010000000001010000000100010101000000000001000100010100011
1011110010111010101010111010111010111011110111100111111110101111
1000001000000000100010000010000000100000000010100000001000000011
1111100011111110001011101011111110100111111010111011100010111111
1000001010001000101000100000001000100010000010000000101000000011
1011111010101011001010101010101110111010111110111110001111011011
1000000000101010000000101010001000000010100000000010101000100011
1110000111100110111011101110111010011010101111111011101010001011
1000001000100010000010001000100010000010001000000000001010000001
1011111110111001111100111011001011100111111010100111111000101011
1000000000001000000000100000001000000000000000000000000010000011
1001111111111111110111111101110111110111111101011010111111001111
1111111111111111111111111111111111111111111111111111111111111111
