NO ./textures/wall.xpm
SO ./textures/wall.xpm
WE ./textures/wall.xpm
EA ./textures/wall.xpm

F 90,90,90
C 150,150,150

111111
1E0001
111001
100001
111111
