NO ./textures/wall.xpm
SO ./textures/wall.xpm
WE ./textures/wall.xpm
EA ./textures/wall.xpm

F 80,80,80
C 180,180,180

1111111
1N00001
1011101
1000001
1111111
