NO ./textures/wall.xpm
SO ./textures/wall.xpm
WE ./textures/wall.xpm
EA ./textures/wall.xpm

F 120,120,120
C 220,220,220

111111111
1N0000001
100111001
100000001
111111111
