NO ./textures/wall.xpm
SO ./textures/wall.xpm
WE ./textures/wall.xpm
EA ./textures/wall.xpm

F 50,50,50
C 180,180,180

111111111
1N0000001
111111111
