NO ./assets/textures/univers2/north.xpm
SO ./assets/textures/univers2/south.xpm
WE ./assets/textures/univers2/east.xpm
EA ./assets/textures/univers2/west.xpm

F 85,85,85
C 210,210,230

                                    1111111111111111111
                                        111111111111111111111111111111111111111111111
                                111000000000000000000000000000000000000000000111
                         111111111111111111111111111111111111111111111 11
                        1100100000000000001111111111111111000000000001  11
                      101111111111101000000000000001011111111101   11
                11101000000000101011111111111101010000000101    11
                11101011111110101010000000000101011111110101    11
                101010000010101010111111110101010000010101
                101010111010101010100000010101011101010101
                101010101010101010101110010101010101010101
                101010101010101010101010010101010101010101
                101010101011101110101010010111011101010101
                101010101000000010101010010000000101010101
                101010101111111010101010011111111101010101     11
                101010100000001010101010010000000101010101     11
                11101010111111101010101010011111110101010101    11
                11101010100000001010101010010000000101010101    11
                      101010101111111010101010011111111101010101   11
                        1100101010101000001010101010010000001101010101  11
                         111101010101011101010101010011101110101010101 11
                                111010101010001010101010010100010101010101111
                                        11101010101110101110111011110111010101111
                                                 101010100000100000000000000001010101
                                                 101010111111111111111111111101010101
                                                 101010100000000000000000000001010101
                                                 101010101111110011110011111101010101
                                                 1000000010000000000E0000000010000001
                                                 111111111111111111111111111111111111

