NO  ./assets/textures/lab_green/tile119_256.xpm
SO  ./assets/textures/lab_green/tile121_256.xpm
WE  ./assets/textures/lab_dirt/tile090_256.xpm
EA  ./assets/textures/lab_dirt/tile089_256.xpm

F 48,48,48
C 206,206,206

  1111      11111111
 100001 1  1000000001
1000001101110000000011
 10100P0000P00111100101
10000010000101   100P0111111
 10000111P111    10010100001
10000011100001  11P110P000W1
 11P1111000001 1000110100001
 100011101P111 100011011111
 10001  110011111111101
 1111111110000000000001
 10000000110111111P11111
100000000P001  1000000001
 100000001111 1000000001
1000000001     1000000001
 100000001      11100111
  1110111         1111
     1
